[{
	"l1": "0",
	"l2": "1",
	"l3": "2",
	"l4": "3",
	"l5": "4",
	"l6": "5",
	"l7": "6",
	"l8": "7",
	"l9": "8",
	"l10": "9",
	"l11": "uit"
}]
