[{
	"l1": "Start",
	"l2": "M3",
	"l3": "E3",
	"l4": "M4",
	"l5": "E4",
	"l6": "M5",
	"l7": "E5",
	"l8": "M6",
	"l9": "E6",
	"l10": "M7",
	"l11": "E7",
	"l12": "Plus"
}]
